b	ㄅ
p	ㄆ
m	ㄇ
f	ㄈ
d	ㄉ
t	ㄊ
n	ㄋ
l	ㄌ
g	ㄍ
k	ㄎ
h	ㄏ
j	ㄐ
q	ㄑ
x	ㄒ
zh	ㄓ
ch	ㄔ
sh	ㄕ
r	ㄖ
z	ㄗ
c	ㄘ
s	ㄙ
i	ㄧ
u	ㄨ
v	ㄩ
a	ㄚ
o	ㄛ
e	ㄜ
e	ㄝ
ai	ㄞ
ei	ㄟ
ao	ㄠ
ou	ㄡ
an	ㄢ
en	ㄣ
ang	ㄤ
eng	ㄥ
er	ㄦ
2	ˊ
3	ˇ
4	ˋ
0	˙
